111111111111111111111111111
1P0000000000C00000000000C01
100000C00111011111100000001
1C0000001110011C11100000001
10000001110001001110000C001
100000111000000111000000001
10000111C000001110000000001
1000111111110111001000C0001
1000111111110111C1100000001
100000000111011111100000001
100000C00111000000000000001
1000000001110000000C0000001
1E000000000000000000000C001
111111111111111111111111111