1111111111111111
1P00C01000010001
100000E101010101
100C001001000101
1111111111111111