1111111111111111
1P00C01000010001
100000E001010101
100C0010010001C1
1111111111111111