11111111111111111111
10C01000C100000C0001
10101011110011111101
101010111100000000E1
10100000000001111111
101011110001110001C1
1P1000C1000C00010001
11111111111111111111