1111111111111111111111111111111111
1P000C000001000000000C000000000001
1011110111010111111101110111111101
1000010000010000000100010000000101
1111011111011111110101111101110101
1C00000000100000C00100000100100001
1011110111110111111111101111011101
1000000000000000000000100000010001
1111101110111111111110111111010111
1C000000001000C0000010000000010001
1011101111010111111011111011111101
1000000000010000000000000010000001
1110111111011111111111111011110101
1C000000001000000C0000000010000101
1010111111110111111111111111011101
10000000000000000000000000000000E1
1111111111111111111111111111111111
