1111111111111111111111111111111111111111111111111111111111111111111111111111111111111111111111111111
1111111111111111111101111111111111111111111111111110011111111100011100000000101110111111111111111111
1111111111110011110101111111111111111111111111111110011111111100000111000000000000111111111111111111
1111111111000000100000011111111111111111111111111110011111111100000000000000000001111111111111111111
1111111111000000000000011111111111111111111111111110011111011100000000000000010000111111111111111111
1111111100010000000011111111111111111111111111111110001111000000000000000000000000111111001111111111
1111111100000010000011111111111111111111111111111110001101000000000000000000000000000000001111111111
1111111111000000000011111111111111111111111111111111000100000000000000000000000000001110001111111111
1111111111100000000000111111111111111111111111110000000001000000000000000000000000011000101111111111
1111111111110000000000111111111111111111111111110000000011000000000000000000000000000000001110000011
1111110000000000000000111111111111111111111111100110000010000000000000000000000000000000000011000001
1111110000000000000000111111111111111111110001000110000000100000000000000000000000000000000010011101
1111110000000000000000111111111100001111110010000000000000000000000000000000000000000000000000111101
1111100001000000000000111111111000000011111001110000000000000000001100000000000000000000000000111111
1111100000010000000010001111100000000001011000000000000000000000000000000000000000000000000000111111
1111100000000000000000001111000001110000001000000000000001000000000000000000000000000000000000111111
1111110011111000000001101111001111111000000000000000100001100000000000000000000000000000000000111111
1111110001111100000000101111100111111100010000000000110111100000000000000000C00000000000000000111111
1111111001110011000000001111110111110000110000000110111111000000000000000000000000000P00000000000001
1111111100110000000000011111100111110001111000000110011110000000000000000000000000000000000000000001
1111111000110000100000000111000011110100000000000000001100000000000000000000000000000000000000000001
1111111000011100000011010010000001100000000000000000000000000000000000000000000000000000C00000000001
1111111110000010001111100000000000000000000000011000011110100000000000000000000000000000000000000001
1111111111101100001111100000000000000000000000001000011111100000000000000000000000000C00000000000001
1111111111101110000000000000000000000000000000000011111111000000111100000000000000000000000000000111
1111111111000111101011110000000000000000000001000111111110000000111000000000000000000000000000011111
111111111C000111110011000000000000001000000011110111111100010000111100000000000000000000001100100001
11111111111000000110110000000000000011000001101100111111000000101111100000000000000000C0100000000001
111111111111111001000000000000000000111101011000001111110000000011111000000000000000C000000000000011
1111111111111111000000000000000000000010011000000001111000000001110100000000000000000000000000000011
1111111111111111110000000100000000000000111000000001110000011111000000000000000000000000111010010011
1111111111111111110000000100000000000000000010000000110000011111000000000000000000010000111111011111
1111111111111111111100111000000000001100000010000000110000011110000000000000000000110000001111011111
1111111111111111110000010000000000001100100010001001110000001111100000100000000000110000001111111111
1111111111111111000000000001000100001111111111001001000000000011000000000000000000110000001111111111
1111111111111010000000000011011100001111111110001000010010000011100000000000000011110000111111111111
111111111111001000010000000C011100001111111100000011111010010000000000010000000011100011111111111111
1111111111110000000000000000001110000111111000000011111011010000000000010000000000100111111111111111
1111111111110001000001000001111000000000111000000001001000011011100000000000000010000011111111111111
1111111111110001100001100001110000000000011110000000000000111011100000000000000010000011111111111111
1111111111111000000001111010000000000010011111110001111111111111001000001000000011010011111111111111
1111111111111100000011111100000000000010111111111111111111111111000100001111111111010001111111111111
1111111111111111100011111100100000000000000111111111111111111111100110011110000011111111111111111111
111111111111111111111111110011000000000000001111111111111111111111010000110C011001111111111111111111
1111111111111111111111010001110001000000000011111111111111111111110001000000000010001111111111111111
1111111111111111111111000001110000000000000011111111111111111110000101100000000000011111111111111111
1111111111111111111110000001100000110000000001111111111111111110011111100000000000111111111111111111
1111111111111111111000000001100000000000000000000111111111111011011111100000000000111111111111111111
111111111111111111111000000111000000C000000000000011111111000000000011100000001001111111111111111111
1111111111111111111111100100000001000000000000000000101111100010000000100000001111111111111111111111
1111111111111111111110000011110111000000000000000000000111100010000000001000000011111111111111111111
111111111111111111111000011111111000000000001000000000011111011100000C011110000011111111111111111111
1111111111111111111110000111111100000000011100011000000001110011110000011100010111111111111111111111
11111111111111111111110011111110000000000100000110001000011110111110001111C0010111111111111111111111
1111111111111111111111111111111110010001110000011100011000011011111001110000100011111001111111111111
1111111111111111111111111111111111000100111000110100011000000011111000100000101111111001110111111111
1111111111111111111111111111111110001000010001000000001000100011111100100010000011100001000111111111
1111111111111111111111111111111110000010000001000100000100000011111100000000000011010001000111111111
1111111111111111111111111111111111000111000000000000000000110011111100000E11100111000000000111111111
11111111111111111111111111111111111111111000011010000110000110111111111000111001000C0000000111111111
1111111111111111111111111111111111111111100100000010000111010011111111000001110000000001110111111111
1111111111111111111111111111111111111111111101000000000111000001001000000000010000000001100111111111
1111111111111111111111111111111111111111111111000000000111000000000000010000000000000010001111111111
1111111111111111111111111111111111111111111001111000000000000011100000010000001000001110011111111111
1111111111111111111111111111111111110011110001110000000000000011111000000000000000C01000010111111111
1111111111111111111111111111111111000011100000001000000000000000001000000000001100000000000011111111
1111111111111111111111111111111100000011100000000000000000000000000000000000111111000000000011111111
1111111111111111111111111111111110000001000011000000010000000000000000000000111101000000111111111111
1111111111111111111111111111111110000000000111110000000000000000000000000000011100001000111111111111
1111111111111111111111111111000000000000100111110000000000000000000000000000000000000000111111111111
1111111111111111111111111011011000000000100011110000000000000000000000000000000000000000111111111111
1111111111111111111111111000010000000000000011110000000000000000000000000000000000001111111111111111
1111111111111111111111111000011011000000000011100000000001000000000000000011000000011111111111111111
1111111111111111111111111110000011000000000101000000000000000000000000000000000000011111111111111111
111111111111111111111111111000001100000000000C000000000000000000000000000011100111111111111111111111
111111111111111111111111110000001000000000000000000000000000000000C000000001101111111111111111111111
1111111111111111111111101100000000000000000000000000000000000000000000000000001111111111111111111111
1111111111111111110001000000000000000C00000000000000000000000000000000000010111111111111111111111111
1111111111111111110000000000000000000000000000000000000000000000000000000000111111111111111111111111
1111111111111111000001001000000000000000000000000000000000000000000000000000111111111111111111111111
1111111111011111000000000000000000000000000000000000000000000000000000000000000111111111111111111111
1111111110000001110000000100000000000000000000000000000100000000000000100000000001111111111111111111
1111111110000000110000000000000000000000000000000000000000010000000000000000000101111111111111111111
1111111110000000000000000000000CC0000000001000000000000011000000000000000000000001111111111111111111
1111111111000000000000C01000000011100000011100000010000111000100100001100000001001111111111111111111
1111111111000000000000000000000011110001111111110111000111110111000000000000000001111111111111111111
1111111111110100000100000000000111100000111111000011000011110010000000000000000000111111111111111111
1111111111000000000000000000000111000111111111100000C00011111011001100000000000001111111111111111111
1111111110000100001100000000001111001111111111000000010011110000011110000000000011111111111111111111
1111111110000010001100000000000110000011111111001000010011111111111100000000001111111111111111111111
1111111100010001000000011000000000000011111110000000011111111111111100010000001111111111111111111111
1111111100000011111110011000001000100001111110000000011111111111111110010111011111111111111111111111
1111111101000111111111110000001000000000011000111111111111111111111110000011011111111111111111111111
1111111111011101111111111000000000000000000001111111111111111111111110000011011111111111111111111111
1111111111000000111100011100000000000000000011111111111111111111111110000000011111111111111111111111
1111111111111000100000011111111000000100000011111111111111111111111000000000111111111111111111111111
1111111111111100001101111111111100000001000111111111111111111111100000000000111111111111111111111111
1111111111111110001001111111111110000010000111111111111111111111101111000111111111111111111111111111
1111111111111111100001111111111111010010000111111111111111111111000110001111111111111111111111111111
1111111111111111111111111111111111111111111111111111111111111111111111111111111111111111111111111111